1111111111
100000P011
100E10C001
1111111111