1111111111
100C00P011
100E00C001
1111111111