11111111111
100C00000C1
1000000P011
100C0000001
100C0000011
100C000E011
100C0000011
11111111111