111111
1C0001
100E11
1P0011
100001
111111
