1111111111111111111111111111111111111111111111111111111111
1C0000CCCC000000000C1C0000CCCC000000000C000000000C11111111
1000111000000001C0011C0000CCCC000000000C111111111111111111
1P001E000000000CCCC01C0000CCCC000000000C000000000000000001
1000111000000001C0011C0000CCCC000000000C000000000000000001
1000111000000001C0011C0000CCCC000000000C000000000000000001
1000111000000001C0011C0000CCCC000000000C000000000000000001
1C0000CCCC000000000C1C0000CCCC000000000C000000000C00000111
1C0000CCCC000000000C1C0000CCCC000000000C000000000C00000111
1000111000000001C0011C0000CCCC000000000C000000000C00000111
100000000000000000001C0000CCCC000000000C000000000000000001
1C0000C111111110000C111000000001C0011C0000CCCC000000000001
1000101000000001C000000000000000000000001C0011C0000CCCC001
1C0000CCCC000000000C111000000001C0011C0000CCCC000000001111
1000101000000001C001111000000001C0011C0000CCCC000000001111
100000111110000000000000000000000000000001C0011C0000CCCC01
10000000000000C00000111000000001C0011C0000CCCC000000001111
10000000000000C00000111000000001C0011C0000CCCC000000001111
10000000000000C0000010000000000000000000000C00000000000001
10000C00001000C00000CCCC0000000000000000000000C00000000001
10000C00001000C0000000000000000000000000000000000000000001
10000C0000100C000000CCCC00000000000000000000C0000000000001
1000101000000001C00110000000000000000000000000000000111111
111111111111111111111C0000CCCC000000000C000000000000000001
111111111111111111111C0000CCCC000000000C000000000000000001
111111111111111111111C0000CCCC000000000C000000000000000001
1111111111111111111111111111111111111111111111111111111111