111111111
1001000E1
1C00110C1
1P0000C11
111111111
