11111111111111111
1C0000CCCC0000C11
10001010001100001
11001E1000P0CCC01
1C0000CCCC0100C11
10001010000CCC001
1C0000C1CC0101011
10001010001000011
10001010C011C0001
11111111111111111